babble;utter meaningless|backhanded;indirect|badger;harass persistently|badinage;banter|bait;1.lead away
2.something luring|bale;sorrow|baleful;harmful|balk;1.check obstcale
2.unwillingness|balky;refusing|balderdash;n.having no meaning|balloon;increase|balm;soothe|banal;trite|bane;kill or injure a living thing|banish;leave a country|banter;humored|barb;a critical remark|barbarous;mercilessly harsh|barefaced;brazen|bargain;1. an agreement
2. negotiate|baroque;complex, flamboyant|barrage;an overwhelming outpouring|barren;1. unproductive
2. deficient|barricade;1. an obstruction
2. prevent access|barter;trade without money|beguile;believe what is untrue|bathetic;commonplace|befuddle;throw into mental uncertainty|bedeck;make more attractive|belabor;1. criticize
2. explain excessively|beleaguer;trouble|belie;1. shut off from view
2. be counter to|bellwether;one that takes the lead|beneficent;1. charitable
2. contributing to social well-being|benign;not causing hurt|berate;scold vehemently|beseech;beg|besmirch;detract from the honor|bifurcate;divide into two branched|bigot;a person obstinately devoted to his own opinions|bland;dull|blandishment;something that tends to coax or cajole|blas√©;apathetic|blast;1. an explosion
2. cause to break open
3. criticize harshly|blatant;noticeable|blazon;1. make known openly
2. make more attractive
|blemish;1. a noticeable imperfection
2. make more attractive|blight;1. affect with blight
2. impair|bliss;ecstasy|blithe;1. happy, lighthearted
2. having freedom from worries|blueprint;work out in advance|blunder;1. an error
2. make a mistake|blunt;1. make less sharp
2. direct, brief|blur;1. become vague
2. make unclear |blurt;utter abruptly|bluster;1. speak in an arrogant manner
2. noisy |boggle;hesitate|boisterous;noisily turbulent|bolster;1. provide support
2. give a boost to|bombast;pompous speech|bonhomie;geniality|boo;a sound uttered to show contempt|boon;benefit|boorish;impolite|bootless;useless|bound;1. a limit
2. fully committed|boycott;engage in a concerted refusal|bracing;giving strength|brake;proceed at a less rapid pace|brash;bold|brassy;displaying rude boldness|bravado;1. a pretense of bravery
2. swaggering conduct|bravura;brilliant technique in performance|brazen;1. contemptuously bold
2. face with self-assurance|breach;fail to keep|brevity;shortness|bribe;give money to a person to influence his conduct|bridle;keep from exceeding|brisk;marked by much life or activity|bristle;express one's anger|brittle;1. easily broken
2. lacking in friendlyness|broach;present for discussion|bromide;a hackneyed statement|brook;tolerate|browbeat;intimidate|bruit;make the subject of common talk without authority|buck;refuse assent|budge;cease resistance|bulge;a protuberant|bully;a person who treats others in an intimidating manner|bumptious;having a feeling of supreority|bungle;work clumsily|buoy;fill with courage or strength|buoyant;showing a good mood|burgeon;grow rapidly|burlesque;make fun of|burnish;make smooth or glossy|buttress;provide evidence or information for|byzantine;complicated or secretive|backfire;reverse|backslide;revert to a worse condition|baffle;mental uncertainty|bohemian;protest against or indifference to convention|bash;criticize harshly|beholden;owing gratitude|behoove;necessary, proper, advantageous|beige;lacking distinction|bureaucratic;complicated rules; long delays|belligerent;assertiveness, hostility, combativeness|beset;1. cause persistent suffering
2. set upon|bewitching;attract|blackmail;extortion of money|bluff;1. direct, brief, potentially rude
2. deceive|bogus;being such in appearance only|bore;1. causes boredom
2. make weary|brandish;shake menacingly|brim;1. outer margin
2. full often to overflowing|bumble;rapidly, inarticulately|bustle;1. noisy, energetic
2. move briskly|